11111111111111111
1P000011000000001
100000C0000011101
11100000000CC1001
1000000000E010101
10001111100001001
11111111111111111
