11111111111111111
10000011000000001
1P00000C000001111
11100000000CC0001
10000000000000001
1000111110000E001
11111111111111111
