111111111111111111111111
1P00000000000000000000E1
100011100011100011100001
1C001000C000C000C0000C01
100011100011100011100001
100000000000000000000001
101111101111101111101101
1C00000C00000C00000C00C1
101111101111101111101101
100000000000000000000001
111111111111111111111111