11111111111111111
10000011C00000001
1P0000000000C1111
1110000C00CC00001
1E000000000000001
10001111100000001
11111111111111111
